//MAP CONVERTED BY dmm2tgm.py THIS HEADER COMMENT PREVENTS RECONVERSION, DO NOT REMOVE
"am" = (
/obj/effect/alien/weeds,
/mob/living/carbon/xenomorph/runner,
/turf/open/asphalt/cement,
/area/event)
"bw" = (
/obj/tr_walkway/skill_granter,
/turf/open/asphalt/cement,
/area/event)
"dc" = (
/obj/effect/alien/weeds,
/mob/living/carbon/xenomorph/king,
/turf/open/asphalt/cement,
/area/event)
"dJ" = (
/obj/tr_walkway/clear_button,
/turf/open/asphalt/tile,
/area/event)
"dK" = (
/obj/structure/machinery/cm_vending/sorted/cargo_guns/cargo/blend,
/turf/open/asphalt/cement,
/area/event)
"eC" = (
/obj/effect/alien/weeds,
/mob/living/carbon/xenomorph/crusher,
/turf/open/asphalt/cement,
/area/event)
"eI" = (
/obj/effect/alien/weeds,
/mob/living/carbon/xenomorph/larva,
/turf/open/asphalt/cement,
/area/event)
"fn" = (
/obj/structure/machinery/cm_vending/sorted/cargo_ammo/squad{
	req_access = null;
	req_one_access = null;
	req_one_access_txt = "17;18;21";
	vend_x_offset = 0
	},
/turf/open/asphalt/cement,
/area/event)
"gE" = (
/obj/structure/barricade/plasteel,
/turf/open/asphalt/cement,
/area/event)
"gQ" = (
/obj/structure/barricade/metal,
/turf/open/asphalt/cement,
/area/event)
"gY" = (
/obj/effect/alien/weeds,
/mob/living/carbon/xenomorph/lesser_drone,
/turf/open/asphalt/cement,
/area/event)
"gZ" = (
/obj/effect/alien/weeds,
/turf/open/asphalt/cement,
/area/event)
"hu" = (
/obj/effect/alien/weeds,
/obj/effect/alien/weeds/node,
/turf/open/asphalt/cement,
/area/event)
"jc" = (
/obj/structure/barricade/metal/wired,
/turf/open/asphalt/cement,
/area/event)
"kd" = (
/obj/structure/barricade/snow,
/turf/open/asphalt/cement,
/area/event)
"kH" = (
/obj/effect/alien/weeds,
/obj/effect/alien/resin/sticky/fast,
/turf/open/asphalt/cement,
/area/event)
"mR" = (
/obj/effect/alien/weeds,
/mob/living/carbon/xenomorph/predalien,
/turf/open/asphalt/cement,
/area/event)
"ne" = (
/obj/structure/barricade/metal/plasteel,
/turf/open/asphalt/cement,
/area/event)
"nG" = (
/obj/effect/landmark/start/marine,
/obj/effect/landmark/start/liaison,
/obj/effect/landmark/start/professor,
/obj/effect/landmark/start/police,
/obj/effect/landmark/start/otech,
/obj/effect/landmark/start/pilot/dropship_pilot,
/obj/effect/landmark/start/requisition,
/obj/effect/landmark/start/researcher,
/obj/effect/landmark/start/senior,
/obj/effect/landmark/start/synthetic,
/obj/effect/landmark/start/intel,
/obj/effect/landmark/start/marine/engineer,
/obj/effect/landmark/start/marine/leader,
/obj/effect/landmark/start/marine/medic,
/obj/effect/landmark/start/marine/tl,
/obj/effect/landmark/start/marine/smartgunner,
/obj/effect/landmark/start/warden,
/obj/effect/landmark/late_join,
/obj/effect/landmark/start/captain,
/obj/effect/landmark/start/executive,
/obj/effect/landmark/start/bridge,
/obj/effect/landmark/start/cargo,
/obj/effect/landmark/start/warrant,
/obj/effect/landmark/start/working_joe,
/obj/effect/landmark/start/crew_chief,
/obj/effect/landmark/start/pilot/cas_pilot,
/obj/effect/landmark/start/chef,
/obj/effect/landmark/start/doctor,
/obj/effect/landmark/start/engineering,
/obj/effect/landmark/start/marine/spec,
/obj/effect/landmark/start/nurse,
/obj/effect/landmark/start/maint,
/obj/structure/target,
/turf/open/asphalt/cement,
/area/event)
"pb" = (
/obj/structure/barricade/deployable,
/turf/open/asphalt/cement,
/area/event)
"pf" = (
/obj/effect/alien/weeds,
/obj/structure/mineral_door/resin/thick,
/turf/open/asphalt/cement,
/area/event)
"qi" = (
/obj/effect/alien/weeds,
/turf/open/space/basic,
/area/event)
"rm" = (
/obj/structure/machinery/cm_vending/sorted/cargo_guns/squad_prep,
/turf/open/asphalt/cement,
/area/event)
"rq" = (
/obj/structure/machinery/cm_vending/sorted/attachments/blend,
/turf/open/asphalt/cement,
/area/event)
"rL" = (
/turf/open/auto_turf/sand_white,
/area/event)
"rM" = (
/obj/effect/alien/weeds,
/mob/living/carbon/xenomorph/ravager,
/turf/open/asphalt/cement,
/area/event)
"rN" = (
/obj/effect/alien/weeds,
/mob/living/carbon/xenomorph/warrior,
/turf/open/asphalt/cement,
/area/event)
"sa" = (
/obj/effect/alien/weeds,
/turf/closed/wall/resin/membrane,
/area/event)
"wv" = (
/obj/effect/alien/weeds,
/obj/effect/alien/resin/sticky,
/turf/open/asphalt/cement,
/area/event)
"xf" = (
/turf/closed/wall/indestructible,
/area/event)
"xm" = (
/obj/structure/window/framed/colony/reinforced,
/turf/open/asphalt/cement,
/area/event)
"ya" = (
/turf/open/asphalt/tile,
/area/event)
"yp" = (
/obj/effect/alien/weeds,
/mob/living/carbon/xenomorph/boiler,
/turf/open/asphalt/cement,
/area/event)
"zf" = (
/obj/structure/machinery/cm_vending/sorted/cargo_guns/squad{
	req_access = null;
	req_one_access = null;
	req_one_access_txt = "17;18;21";
	vend_x_offset = 0;
	vend_y_offset = 0
	},
/turf/open/asphalt/cement,
/area/event)
"zC" = (
/obj/effect/alien/weeds,
/turf/closed/wall/resin/reflective,
/area/event)
"AJ" = (
/obj/structure/machinery/cm_vending/sorted/attachments/squad{
	req_access = null;
	req_one_access = null;
	req_one_access_txt = "17;18;21";
	vend_y_offset = 0
	},
/turf/open/asphalt/cement,
/area/event)
"Be" = (
/obj/structure/machinery/cm_vending/sorted/uniform_supply/squad_prep,
/turf/open/asphalt/cement,
/area/event)
"BD" = (
/obj/effect/alien/weeds,
/mob/living/carbon/xenomorph/queen,
/turf/open/asphalt/cement,
/area/event)
"BI" = (
/obj/structure/window/framed/colony,
/turf/open/asphalt/cement,
/area/event)
"BX" = (
/obj/structure/barricade/sandbags/wired,
/turf/open/asphalt/cement,
/area/event)
"Dh" = (
/obj/effect/alien/weeds,
/mob/living/carbon/xenomorph/lurker,
/turf/open/asphalt/cement,
/area/event)
"Dp" = (
/obj/tr_walkway/killer,
/turf/open/auto_turf/sand_white,
/area/event)
"GB" = (
/obj/structure/machinery/cm_vending/sorted/cargo_ammo/cargo/blend,
/turf/open/asphalt/cement,
/area/event)
"GY" = (
/obj/structure/barricade/plasteel/metal,
/turf/open/asphalt/cement,
/area/event)
"Ib" = (
/turf/closed/wall/almayer/reinforced,
/area/event)
"Ik" = (
/obj/structure/barricade/wooden,
/turf/open/asphalt/cement,
/area/event)
"IY" = (
/obj/tr_walkway/cloner,
/turf/open/auto_turf/sand_white,
/area/event)
"Jc" = (
/obj/tr_walkway/spawner,
/turf/open/auto_turf/sand_white,
/area/event)
"Ju" = (
/obj/structure/machinery/cm_vending/clothing/marine,
/turf/open/asphalt/cement,
/area/event)
"Jy" = (
/obj/effect/alien/weeds,
/turf/closed/wall/resin/pillar,
/area/event)
"JF" = (
/obj/effect/alien/weeds,
/obj/effect/alien/resin/sticky/thin,
/turf/open/asphalt/cement,
/area/event)
"JS" = (
/obj/effect/alien/weeds,
/mob/living/carbon/xenomorph/drone,
/turf/open/asphalt/cement,
/area/event)
"JV" = (
/obj/effect/alien/weeds,
/mob/living/carbon/xenomorph/praetorian,
/turf/open/asphalt/cement,
/area/event)
"KP" = (
/obj/structure/barricade/sandbags,
/turf/open/asphalt/cement,
/area/event)
"Mb" = (
/turf/closed/wall/almayer,
/area/event)
"No" = (
/obj/structure/barricade/handrail,
/turf/open/asphalt/cement,
/area/event)
"Ny" = (
/obj/effect/alien/weeds,
/turf/closed/wall/resin,
/area/event)
"OZ" = (
/obj/effect/alien/weeds,
/obj/structure/mineral_door/resin,
/turf/open/asphalt/cement,
/area/event)
"Qk" = (
/turf/open/asphalt/cement,
/area/event)
"Rj" = (
/obj/effect/alien/weeds,
/turf/closed/wall/resin/thick,
/area/event)
"Sk" = (
/obj/effect/alien/weeds,
/turf/closed/wall/resin/membrane/thick,
/area/event)
"SJ" = (
/obj/structure/barricade/plasteel/wired,
/turf/open/asphalt/cement,
/area/event)
"Tf" = (
/obj/effect/alien/weeds,
/mob/living/carbon/xenomorph/sentinel,
/turf/open/asphalt/cement,
/area/event)
"Tg" = (
/obj/effect/alien/weeds,
/mob/living/carbon/xenomorph/burrower,
/turf/open/asphalt/cement,
/area/event)
"VD" = (
/obj/effect/alien/weeds,
/mob/living/carbon/xenomorph/hellhound,
/turf/open/asphalt/cement,
/area/event)
"Xd" = (
/obj/effect/alien/weeds,
/mob/living/carbon/xenomorph/defender,
/turf/open/asphalt/cement,
/area/event)
"XQ" = (
/obj/effect/alien/weeds,
/mob/living/carbon/xenomorph/hivelord,
/turf/open/asphalt/cement,
/area/event)
"XW" = (
/obj/effect/alien/weeds,
/mob/living/carbon/xenomorph/carrier,
/turf/open/asphalt/cement,
/area/event)
"Yu" = (
/obj/effect/alien/weeds,
/mob/living/carbon/xenomorph/spitter,
/turf/open/asphalt/cement,
/area/event)

(1,1,1) = {"
xf
xf
xf
xf
xf
xf
xf
xf
xf
xf
xf
xf
xf
xf
xf
xf
xf
xf
xf
xf
xf
xf
xf
xf
xf
xf
xf
xf
xf
xf
xf
xf
"}
(2,1,1) = {"
xf
rL
rL
rL
rL
rL
rL
rL
rL
rL
IY
Jc
Jc
Jc
Jc
Jc
Jc
Jc
Jc
Jc
Jc
rL
rL
rL
rL
rL
rL
rL
rL
rL
rL
xf
"}
(3,1,1) = {"
xf
rL
qi
gZ
gZ
gZ
gZ
gZ
gZ
rL
ya
ya
ya
ya
ya
ya
ya
ya
ya
ya
ya
ya
rL
Qk
Qk
Qk
Qk
Qk
Qk
nG
rL
xf
"}
(4,1,1) = {"
xf
rL
sa
gZ
yp
gZ
rM
gZ
gZ
rL
ya
ya
ya
ya
ya
ya
ya
ya
ya
ya
ya
ya
rL
Qk
Qk
Qk
Qk
Qk
Qk
bw
rL
xf
"}
(5,1,1) = {"
xf
rL
Sk
gZ
gZ
gZ
gZ
gZ
gZ
rL
ya
ya
ya
ya
ya
ya
ya
ya
ya
ya
ya
ya
rL
Qk
Qk
Qk
Qk
Qk
Qk
rm
rL
xf
"}
(6,1,1) = {"
xf
rL
Jy
gZ
Tg
hu
am
gZ
gZ
rL
ya
ya
ya
ya
ya
ya
ya
ya
ya
ya
ya
ya
rL
Qk
Qk
Qk
Qk
Qk
Qk
rm
rL
xf
"}
(7,1,1) = {"
xf
rL
zC
gZ
gZ
gZ
gZ
gZ
gZ
rL
ya
ya
ya
ya
ya
ya
ya
ya
ya
ya
ya
ya
rL
Qk
Qk
Qk
Qk
Qk
Qk
Be
rL
xf
"}
(8,1,1) = {"
xf
rL
Rj
gZ
XW
gZ
Tf
gZ
gZ
rL
ya
ya
ya
ya
ya
ya
ya
ya
ya
ya
ya
ya
rL
Qk
Qk
Qk
Qk
Qk
Qk
zf
rL
xf
"}
(9,1,1) = {"
xf
rL
OZ
gZ
gZ
gZ
gZ
gZ
gZ
rL
ya
ya
ya
ya
ya
ya
dJ
ya
ya
ya
ya
ya
rL
Qk
Qk
Qk
Qk
Qk
Qk
fn
rL
xf
"}
(10,1,1) = {"
xf
rL
pf
gZ
eC
gZ
Yu
gZ
gZ
rL
ya
ya
ya
ya
ya
ya
ya
ya
ya
ya
ya
ya
rL
Qk
Qk
Qk
Qk
Qk
Qk
Ju
rL
xf
"}
(11,1,1) = {"
xf
rL
wv
gZ
gZ
hu
gZ
gZ
gZ
rL
ya
ya
ya
ya
ya
ya
ya
ya
ya
ya
ya
ya
rL
Qk
Qk
Qk
Qk
Qk
Qk
AJ
rL
xf
"}
(12,1,1) = {"
xf
rL
JF
gZ
Xd
gZ
rN
gZ
gZ
rL
ya
ya
ya
ya
ya
ya
ya
ya
ya
ya
ya
ya
rL
Qk
Qk
Qk
Qk
Qk
Qk
rq
rL
xf
"}
(13,1,1) = {"
xf
rL
kH
gZ
gZ
gZ
eI
gZ
gZ
rL
ya
ya
ya
ya
ya
ya
ya
ya
ya
ya
ya
ya
rL
Qk
Qk
Qk
Qk
Qk
Qk
dK
rL
xf
"}
(14,1,1) = {"
xf
rL
gZ
gZ
JS
gZ
gZ
gZ
gZ
rL
ya
ya
ya
ya
ya
ya
ya
ya
ya
ya
ya
ya
rL
Qk
Qk
Qk
Qk
Qk
Qk
GB
rL
xf
"}
(15,1,1) = {"
xf
rL
gZ
gZ
gZ
hu
gZ
gZ
gZ
rL
ya
ya
ya
ya
ya
ya
ya
ya
ya
ya
ya
ya
rL
Qk
Qk
Qk
Qk
Qk
Qk
Mb
rL
xf
"}
(16,1,1) = {"
xf
rL
gZ
gZ
VD
gZ
BD
gZ
gZ
rL
ya
ya
ya
ya
ya
ya
ya
ya
ya
ya
ya
ya
rL
Qk
Qk
Qk
Qk
Qk
Qk
Ib
rL
xf
"}
(17,1,1) = {"
xf
rL
gZ
gZ
gZ
gZ
gZ
gZ
gZ
rL
ya
ya
ya
ya
ya
ya
ya
ya
ya
ya
ya
ya
rL
Qk
Qk
Qk
Qk
Qk
Qk
xm
rL
xf
"}
(18,1,1) = {"
xf
rL
gZ
gZ
XQ
gZ
mR
gZ
gZ
rL
ya
ya
ya
ya
ya
ya
ya
ya
ya
ya
ya
ya
rL
Qk
Qk
Qk
Qk
Qk
Qk
BI
rL
xf
"}
(19,1,1) = {"
xf
rL
gZ
gZ
gZ
hu
gZ
gZ
gZ
rL
ya
ya
ya
ya
ya
ya
ya
ya
ya
ya
ya
ya
rL
Qk
Qk
Qk
Qk
Qk
Qk
Ik
rL
xf
"}
(20,1,1) = {"
xf
rL
gZ
gZ
gY
gZ
dc
gZ
gZ
rL
ya
ya
ya
ya
ya
ya
ya
ya
ya
ya
ya
ya
rL
Qk
Qk
Qk
Qk
Qk
Qk
kd
rL
xf
"}
(21,1,1) = {"
xf
rL
gZ
gZ
gZ
gZ
gZ
gZ
gZ
rL
ya
ya
ya
ya
ya
ya
ya
ya
ya
ya
ya
ya
rL
Qk
Qk
Qk
Qk
Qk
Qk
BX
rL
xf
"}
(22,1,1) = {"
xf
rL
gZ
gZ
JV
gZ
Dh
gZ
gZ
rL
ya
ya
ya
ya
ya
ya
ya
ya
ya
ya
ya
ya
rL
Qk
Qk
Qk
Qk
Qk
Qk
KP
rL
xf
"}
(23,1,1) = {"
xf
rL
gZ
gZ
gZ
hu
gZ
gZ
gZ
rL
ya
ya
ya
ya
ya
ya
ya
ya
ya
ya
ya
ya
rL
Qk
Qk
Qk
Qk
Qk
Qk
SJ
rL
xf
"}
(24,1,1) = {"
xf
rL
gZ
gZ
gZ
gZ
gZ
gZ
gZ
rL
ya
ya
ya
ya
ya
ya
dJ
ya
ya
ya
ya
ya
rL
Qk
Qk
Qk
Qk
Qk
Qk
GY
rL
xf
"}
(25,1,1) = {"
xf
rL
gZ
gZ
gZ
gZ
gZ
gZ
gZ
rL
ya
ya
ya
ya
ya
ya
ya
ya
ya
ya
ya
ya
rL
Qk
Qk
Qk
Qk
Qk
Qk
gE
rL
xf
"}
(26,1,1) = {"
xf
rL
gZ
gZ
gZ
gZ
gZ
gZ
gZ
rL
ya
ya
ya
ya
ya
ya
ya
ya
ya
ya
ya
ya
rL
Qk
Qk
Qk
Qk
Qk
Qk
jc
rL
xf
"}
(27,1,1) = {"
xf
rL
gZ
gZ
gZ
hu
gZ
gZ
gZ
rL
ya
ya
ya
ya
ya
ya
ya
ya
ya
ya
ya
ya
rL
Qk
Qk
Qk
Qk
Qk
Qk
ne
rL
xf
"}
(28,1,1) = {"
xf
rL
gZ
gZ
gZ
gZ
gZ
gZ
gZ
rL
ya
ya
ya
ya
ya
ya
ya
ya
ya
ya
ya
ya
rL
Qk
Qk
Qk
Qk
Qk
Qk
gQ
rL
xf
"}
(29,1,1) = {"
xf
rL
gZ
gZ
gZ
gZ
gZ
gZ
gZ
rL
ya
ya
ya
ya
ya
ya
ya
ya
ya
ya
ya
ya
rL
Qk
Qk
Qk
Qk
Qk
Qk
No
rL
xf
"}
(30,1,1) = {"
xf
rL
Ny
gZ
gZ
gZ
gZ
gZ
gZ
rL
ya
ya
ya
ya
ya
ya
ya
ya
ya
ya
ya
ya
rL
Qk
Qk
Qk
Qk
Qk
Qk
pb
rL
xf
"}
(31,1,1) = {"
xf
rL
rL
rL
rL
rL
rL
rL
rL
rL
Dp
Dp
Dp
Dp
Dp
Dp
Dp
Dp
Dp
Dp
Dp
Dp
rL
rL
rL
rL
rL
rL
rL
rL
rL
xf
"}
(32,1,1) = {"
xf
xf
xf
xf
xf
xf
xf
xf
xf
xf
xf
xf
xf
xf
xf
xf
xf
xf
xf
xf
xf
xf
xf
xf
xf
xf
xf
xf
xf
xf
xf
xf
"}
